1111111111111
10C1C100C00C1
1001010111101
1P0000001E001
1111111111111
