1111111111111
10C1C100C00C1
1001011011101
1P0000000E1C1
1111111111111
