1111111111111111111111111111111111111111
100000000000000010C100000000000000000001
1000000000000000010100000000000000000001
1000000000000000001000000000000000000001
1000000000000000000100000000000000000001
1000000000000000000010000000000000000001
1000000000000000000001000000000000000001
1000000000000000000000100000000000000001
1000000000000000000000010000000000000001
1000000000000000000000000000000000000001
1000000000000000000000000100000000000001
1000000000000000000000000010000000000001
100000P0000000000000000000010000000000E1
1111111111111111111111111111111111111111
